//MAP CONVERTED BY dmm2tgm.py THIS HEADER COMMENT PREVENTS RECONVERSION, DO NOT REMOVE
"aA" = (
/obj/effect/spawner/structure/window/hollow/reinforced/middle,
/turf/open/floor/plating,
/area/ruin/space/has_grav/cloning_lab)
"aK" = (
/obj/effect/turf_decal/stripes/line{
	dir = 8
	},
/obj/effect/decal/cleanable/dirt,
/obj/machinery/atmospherics/pipe/simple/supply/hidden/layer2{
	dir = 5
	},
/turf/open/floor/plasteel/white,
/area/ruin/space/has_grav/cloning_lab)
"aS" = (
/turf/open/floor/plating/airless,
/area/ruin/space/has_grav/cloning_lab)
"bt" = (
/obj/machinery/vending/snack/teal,
/obj/effect/decal/cleanable/dirt,
/turf/open/floor/plasteel/airless,
/area/ruin/space/has_grav/cloning_lab)
"cu" = (
/obj/item/stack/rods,
/turf/template_noop,
/area/template_noop)
"dg" = (
/obj/effect/decal/cleanable/glass,
/obj/structure/cable{
	icon_state = "2-8"
	},
/obj/machinery/atmospherics/pipe/simple/supply/hidden/layer2{
	dir = 10
	},
/obj/machinery/atmospherics/pipe/simple/scrubbers/hidden/layer4{
	dir = 10
	},
/turf/open/floor/plating/airless{
	icon_state = "platingdmg1"
	},
/area/ruin/space/has_grav/cloning_lab)
"dj" = (
/obj/effect/decal/cleanable/cobweb/cobweb2,
/obj/effect/turf_decal/tile/blue{
	dir = 1
	},
/obj/effect/turf_decal/tile/blue,
/obj/effect/turf_decal/tile/blue{
	dir = 4
	},
/obj/effect/turf_decal/tile/blue{
	dir = 8
	},
/obj/effect/decal/cleanable/dirt,
/turf/open/floor/plasteel/white,
/area/ruin/space/has_grav/cloning_lab)
"dl" = (
/obj/structure/fluff/broken_flooring{
	dir = 8;
	icon_state = "plating";
	name = "broken plating"
	},
/obj/structure/lattice,
/obj/machinery/atmospherics/pipe/simple/supply/hidden/layer2,
/turf/template_noop,
/area/ruin/space/has_grav/cloning_lab)
"eF" = (
/obj/effect/turf_decal/tile/blue{
	dir = 4
	},
/obj/effect/decal/cleanable/dirt,
/turf/open/floor/plasteel/white,
/area/ruin/space/has_grav/cloning_lab)
"fn" = (
/obj/machinery/door/airlock/research/glass{
	name = "Isolation Room"
	},
/obj/effect/turf_decal/stripes/line,
/obj/effect/turf_decal/stripes/line{
	dir = 1
	},
/obj/effect/mapping_helpers/airlock/cyclelink_helper{
	dir = 8
	},
/obj/effect/decal/cleanable/dirt,
/obj/machinery/atmospherics/pipe/simple/supply/hidden/layer2{
	dir = 4
	},
/obj/machinery/atmospherics/pipe/simple/scrubbers/hidden/layer4{
	dir = 8
	},
/turf/open/floor/plasteel,
/area/ruin/space/has_grav/cloning_lab)
"gh" = (
/obj/item/stack/tile/plasteel,
/turf/template_noop,
/area/template_noop)
"gO" = (
/obj/machinery/light{
	dir = 4
	},
/obj/structure/bed,
/obj/item/bedsheet/medical,
/obj/effect/decal/cleanable/dirt,
/turf/open/floor/plasteel,
/area/ruin/space/has_grav/cloning_lab)
"hM" = (
/obj/structure/chair/office{
	dir = 1
	},
/obj/effect/turf_decal/tile/blue{
	dir = 1
	},
/obj/effect/turf_decal/tile/blue{
	dir = 4
	},
/obj/effect/decal/cleanable/dirt,
/turf/open/floor/plasteel/white,
/area/ruin/space/has_grav/cloning_lab)
"im" = (
/obj/machinery/light{
	dir = 4
	},
/obj/effect/turf_decal/tile/blue{
	dir = 1
	},
/obj/effect/decal/cleanable/dirt,
/turf/open/floor/plasteel/white,
/area/ruin/space/has_grav/cloning_lab)
"jo" = (
/obj/machinery/door/airlock/research/glass{
	name = "Cloning Lab"
	},
/obj/structure/cable{
	icon_state = "4-8"
	},
/obj/machinery/atmospherics/pipe/simple/supply/hidden/layer2{
	dir = 4
	},
/obj/machinery/atmospherics/pipe/simple/scrubbers/hidden/layer4{
	dir = 4
	},
/turf/open/floor/plasteel/airless,
/area/ruin/space/has_grav/cloning_lab)
"jZ" = (
/turf/template_noop,
/area/template_noop)
"kk" = (
/obj/structure/sign/directions/science{
	dir = 8
	},
/turf/closed/wall/r_wall,
/area/ruin/space/has_grav/cloning_lab)
"li" = (
/obj/effect/decal/remains/human,
/obj/effect/decal/cleanable/blood/old,
/obj/effect/decal/cleanable/dirt,
/turf/open/floor/plasteel,
/area/ruin/space/has_grav/cloning_lab)
"mI" = (
/turf/closed/wall,
/area/ruin/space/has_grav/cloning_lab)
"mK" = (
/obj/effect/decal/cleanable/dirt,
/obj/machinery/atmospherics/components/unary/vent_pump/on/layer2,
/turf/open/floor/plasteel/airless,
/area/ruin/space/has_grav/cloning_lab)
"oe" = (
/obj/structure/table,
/obj/item/flashlight/lamp,
/obj/effect/decal/cleanable/cobweb,
/obj/effect/turf_decal/tile/blue{
	dir = 1
	},
/obj/effect/turf_decal/tile/blue,
/obj/effect/turf_decal/tile/blue{
	dir = 4
	},
/obj/effect/turf_decal/tile/blue{
	dir = 8
	},
/obj/effect/decal/cleanable/dirt,
/turf/open/floor/plasteel/white,
/area/ruin/space/has_grav/cloning_lab)
"pg" = (
/obj/item/stack/cable_coil/cut/red,
/turf/template_noop,
/area/template_noop)
"qE" = (
/obj/effect/decal/cleanable/dirt,
/obj/machinery/atmospherics/pipe/simple/supply/hidden/layer2{
	dir = 4
	},
/obj/machinery/atmospherics/components/unary/vent_scrubber/on/layer4,
/turf/open/floor/plasteel/white,
/area/ruin/space/has_grav/cloning_lab)
"qR" = (
/obj/structure/table/glass,
/obj/effect/decal/cleanable/dirt,
/obj/machinery/atmospherics/pipe/manifold/scrubbers/hidden/layer4,
/turf/open/floor/plasteel/white,
/area/ruin/space/has_grav/cloning_lab)
"qW" = (
/obj/machinery/iv_drip,
/obj/effect/decal/cleanable/dirt,
/obj/machinery/atmospherics/components/unary/vent_scrubber/on/layer4,
/turf/open/floor/plasteel,
/area/ruin/space/has_grav/cloning_lab)
"rE" = (
/obj/structure/chair/comfy{
	dir = 8
	},
/obj/effect/decal/cleanable/dirt,
/turf/open/floor/plasteel,
/area/ruin/space/has_grav/cloning_lab)
"ui" = (
/obj/structure/sign/nanotrasen,
/turf/closed/wall,
/area/ruin/space/has_grav/cloning_lab)
"uu" = (
/obj/machinery/computer/prototype_cloning,
/obj/machinery/light{
	dir = 1
	},
/obj/item/paper/fluff/ruins/exp_cloning/manual,
/obj/effect/turf_decal/tile/blue{
	dir = 1
	},
/obj/effect/turf_decal/tile/blue,
/obj/effect/turf_decal/tile/blue{
	dir = 4
	},
/obj/effect/turf_decal/tile/blue{
	dir = 8
	},
/obj/effect/decal/cleanable/dirt,
/turf/open/floor/plasteel/white,
/area/ruin/space/has_grav/cloning_lab)
"uV" = (
/obj/effect/turf_decal/stripes/line{
	dir = 1
	},
/obj/effect/turf_decal/stripes/line,
/obj/effect/decal/cleanable/dirt,
/obj/machinery/atmospherics/pipe/simple/supply/hidden/layer2{
	dir = 4
	},
/obj/machinery/atmospherics/pipe/simple/scrubbers/hidden/layer4{
	dir = 8
	},
/turf/open/floor/plasteel,
/area/ruin/space/has_grav/cloning_lab)
"vn" = (
/obj/machinery/dna_scannernew,
/obj/effect/turf_decal/tile/blue{
	dir = 1
	},
/obj/effect/turf_decal/tile/blue,
/obj/effect/turf_decal/tile/blue{
	dir = 4
	},
/obj/effect/turf_decal/tile/blue{
	dir = 8
	},
/obj/effect/decal/cleanable/dirt,
/turf/open/floor/plasteel/white,
/area/ruin/space/has_grav/cloning_lab)
"vp" = (
/turf/closed/wall/r_wall,
/area/ruin/space/has_grav/cloning_lab)
"wb" = (
/obj/effect/decal/cleanable/vomit/old,
/obj/effect/turf_decal/tile/blue{
	dir = 1
	},
/obj/effect/turf_decal/tile/blue,
/obj/effect/turf_decal/tile/blue{
	dir = 4
	},
/obj/effect/turf_decal/tile/blue{
	dir = 8
	},
/obj/machinery/defibrillator_mount/loaded{
	pixel_y = 32
	},
/obj/effect/decal/cleanable/dirt,
/turf/open/floor/plasteel/white,
/area/ruin/space/has_grav/cloning_lab)
"xK" = (
/obj/effect/decal/cleanable/dirt,
/obj/machinery/atmospherics/pipe/simple/supply/hidden/layer2{
	dir = 6
	},
/obj/machinery/atmospherics/pipe/simple/scrubbers/hidden/layer4{
	dir = 5
	},
/turf/open/floor/plasteel,
/area/ruin/space/has_grav/cloning_lab)
"An" = (
/obj/structure/table,
/obj/item/pen,
/obj/item/paper/fluff/ruins/exp_cloning/log,
/obj/effect/turf_decal/tile/blue{
	dir = 1
	},
/obj/effect/turf_decal/tile/blue,
/obj/effect/turf_decal/tile/blue{
	dir = 4
	},
/obj/effect/turf_decal/tile/blue{
	dir = 8
	},
/obj/effect/decal/cleanable/dirt,
/turf/open/floor/plasteel/white,
/area/ruin/space/has_grav/cloning_lab)
"Bn" = (
/obj/effect/decal/cleanable/dirt,
/obj/machinery/atmospherics/pipe/manifold/supply/hidden/layer2,
/obj/machinery/atmospherics/pipe/simple/scrubbers/hidden/layer4{
	dir = 10
	},
/turf/open/floor/plasteel/white,
/area/ruin/space/has_grav/cloning_lab)
"Dg" = (
/obj/effect/turf_decal/tile/blue{
	dir = 1
	},
/obj/effect/turf_decal/tile/blue{
	dir = 4
	},
/obj/effect/decal/cleanable/dirt,
/turf/open/floor/plasteel/white,
/area/ruin/space/has_grav/cloning_lab)
"DR" = (
/obj/effect/decal/cleanable/dirt,
/obj/machinery/atmospherics/pipe/simple/supply/hidden/layer2{
	dir = 4
	},
/obj/machinery/atmospherics/pipe/simple/scrubbers/hidden/layer4{
	dir = 4
	},
/turf/open/floor/plasteel/white,
/area/ruin/space/has_grav/cloning_lab)
"Ef" = (
/turf/closed/wall/r_wall/rust,
/area/ruin/space/has_grav/cloning_lab)
"EF" = (
/obj/effect/spawner/structure/window/hollow/reinforced/end{
	dir = 4
	},
/turf/open/floor/plating,
/area/ruin/space/has_grav/cloning_lab)
"Ff" = (
/obj/machinery/light{
	dir = 8
	},
/obj/effect/turf_decal/stripes/line{
	dir = 8
	},
/obj/effect/decal/cleanable/dirt,
/turf/open/floor/plasteel/white,
/area/ruin/space/has_grav/cloning_lab)
"Fy" = (
/turf/open/floor/plasteel/airless,
/area/ruin/space/has_grav/cloning_lab)
"FK" = (
/obj/effect/turf_decal/stripes/line{
	dir = 8
	},
/obj/effect/decal/cleanable/dirt,
/obj/machinery/atmospherics/pipe/manifold/supply/hidden/layer2{
	dir = 1
	},
/obj/machinery/atmospherics/pipe/simple/scrubbers/hidden/layer4{
	dir = 8
	},
/turf/open/floor/plasteel/white,
/area/ruin/space/has_grav/cloning_lab)
"GC" = (
/obj/item/stack/rods,
/obj/item/stack/cable_coil/cut/red,
/turf/template_noop,
/area/template_noop)
"GK" = (
/obj/effect/spawner/structure/window/hollow/reinforced/middle{
	dir = 4
	},
/turf/open/floor/plating,
/area/ruin/space/has_grav/cloning_lab)
"GN" = (
/obj/effect/spawner/structure/window/hollow/reinforced/end{
	dir = 1
	},
/turf/open/floor/plating/airless,
/area/ruin/space/has_grav/cloning_lab)
"GP" = (
/obj/structure/chair/office{
	dir = 1
	},
/obj/effect/turf_decal/tile/blue{
	dir = 1
	},
/obj/effect/turf_decal/tile/blue,
/obj/effect/turf_decal/tile/blue{
	dir = 4
	},
/obj/effect/turf_decal/tile/blue{
	dir = 8
	},
/obj/effect/decal/cleanable/dirt,
/turf/open/floor/plasteel/white,
/area/ruin/space/has_grav/cloning_lab)
"GS" = (
/obj/effect/decal/cleanable/dirt,
/obj/structure/cable{
	icon_state = "4-8"
	},
/obj/machinery/atmospherics/pipe/simple/supply/hidden/layer2{
	dir = 4
	},
/obj/machinery/atmospherics/pipe/simple/scrubbers/hidden/layer4{
	dir = 4
	},
/turf/open/floor/plasteel/airless,
/area/ruin/space/has_grav/cloning_lab)
"Hd" = (
/obj/structure/lattice,
/turf/template_noop,
/area/template_noop)
"Hn" = (
/obj/effect/decal/cleanable/dirt,
/obj/machinery/atmospherics/pipe/simple/supply/hidden/layer2{
	dir = 4
	},
/obj/machinery/atmospherics/pipe/simple/scrubbers/hidden/layer4{
	dir = 8
	},
/turf/open/floor/plasteel,
/area/ruin/space/has_grav/cloning_lab)
"Ih" = (
/obj/effect/spawner/structure/window/hollow/reinforced/end{
	dir = 8
	},
/turf/open/floor/plating,
/area/ruin/space/has_grav/cloning_lab)
"Ko" = (
/obj/structure/cable{
	icon_state = "2-4"
	},
/obj/effect/decal/cleanable/dirt,
/obj/machinery/atmospherics/pipe/simple/supply/hidden/layer2{
	dir = 4
	},
/obj/machinery/atmospherics/pipe/simple/scrubbers/hidden/layer4{
	dir = 4
	},
/turf/open/floor/plasteel/white,
/area/ruin/space/has_grav/cloning_lab)
"KP" = (
/obj/effect/decal/cleanable/dirt,
/obj/machinery/vending/cola/blue,
/turf/open/floor/plasteel/airless,
/area/ruin/space/has_grav/cloning_lab)
"Lh" = (
/obj/machinery/clonepod/experimental,
/obj/effect/turf_decal/tile/blue{
	dir = 1
	},
/obj/effect/turf_decal/tile/blue,
/obj/effect/turf_decal/tile/blue{
	dir = 4
	},
/obj/effect/turf_decal/tile/blue{
	dir = 8
	},
/obj/effect/decal/cleanable/dirt,
/turf/open/floor/plasteel/white,
/area/ruin/space/has_grav/cloning_lab)
"Lu" = (
/obj/machinery/light{
	dir = 4
	},
/obj/structure/bookcase/random/fiction,
/obj/machinery/airalarm/directional/south,
/turf/open/floor/plasteel,
/area/ruin/space/has_grav/cloning_lab)
"LT" = (
/obj/effect/turf_decal/tile/blue{
	dir = 1
	},
/obj/effect/turf_decal/tile/blue{
	dir = 4
	},
/obj/effect/decal/cleanable/dirt,
/obj/machinery/atmospherics/components/unary/vent_pump/on/layer2,
/turf/open/floor/plasteel/white,
/area/ruin/space/has_grav/cloning_lab)
"Me" = (
/obj/effect/spawner/structure/window/hollow/reinforced/directional{
	dir = 9
	},
/turf/open/floor/plating,
/area/ruin/space/has_grav/cloning_lab)
"MN" = (
/obj/effect/decal/cleanable/dirt,
/obj/machinery/atmospherics/pipe/simple/supply/hidden/layer2{
	dir = 4
	},
/obj/machinery/atmospherics/pipe/simple/scrubbers/hidden/layer4{
	dir = 6
	},
/turf/open/floor/plasteel/white,
/area/ruin/space/has_grav/cloning_lab)
"Nm" = (
/obj/structure/cable{
	icon_state = "4-8"
	},
/obj/machinery/atmospherics/pipe/manifold/supply/hidden/layer2,
/obj/machinery/atmospherics/pipe/manifold/scrubbers/hidden/layer4{
	dir = 1
	},
/turf/open/floor/plating/airless,
/area/ruin/space/has_grav/cloning_lab)
"NV" = (
/obj/item/book/random/triple,
/obj/effect/decal/cleanable/dirt,
/turf/open/floor/plasteel,
/area/ruin/space/has_grav/cloning_lab)
"Ow" = (
/obj/structure/sign/departments/science,
/turf/closed/wall,
/area/ruin/space/has_grav/cloning_lab)
"OG" = (
/obj/effect/decal/cleanable/dirt,
/obj/machinery/atmospherics/components/binary/valve/on/layer2{
	dir = 4
	},
/turf/open/floor/plasteel/white,
/area/ruin/space/has_grav/cloning_lab)
"PT" = (
/obj/effect/spawner/structure/window/hollow/reinforced/directional{
	dir = 10
	},
/turf/open/floor/plating,
/area/ruin/space/has_grav/cloning_lab)
"Qk" = (
/obj/machinery/airalarm/directional/south,
/obj/effect/decal/cleanable/dirt,
/obj/machinery/portable_atmospherics/canister/air,
/obj/machinery/atmospherics/components/unary/portables_connector/visible/layer2{
	dir = 8
	},
/turf/open/floor/plasteel/white,
/area/ruin/space/has_grav/cloning_lab)
"RI" = (
/obj/structure/table/glass,
/obj/item/storage/firstaid/regular,
/obj/item/healthanalyzer{
	desc = "A prototype hand-held body scanner able to distinguish vital signs of the subject.";
	name = "prototype health analyzer"
	},
/obj/effect/decal/cleanable/dirt,
/obj/machinery/atmospherics/pipe/simple/scrubbers/hidden/layer4{
	dir = 9
	},
/turf/open/floor/plasteel/white,
/area/ruin/space/has_grav/cloning_lab)
"Sa" = (
/obj/effect/decal/cleanable/dirt,
/obj/machinery/atmospherics/components/unary/vent_pump/on/layer2{
	dir = 1
	},
/turf/open/floor/plasteel,
/area/ruin/space/has_grav/cloning_lab)
"SO" = (
/obj/machinery/door/airlock/research/glass{
	name = "Isolation Room"
	},
/obj/effect/turf_decal/stripes/line{
	dir = 1
	},
/obj/effect/turf_decal/stripes/line,
/obj/effect/mapping_helpers/airlock/cyclelink_helper{
	dir = 4
	},
/obj/effect/decal/cleanable/dirt,
/obj/machinery/atmospherics/pipe/simple/supply/hidden/layer2{
	dir = 4
	},
/obj/machinery/atmospherics/pipe/simple/scrubbers/hidden/layer4{
	dir = 8
	},
/turf/open/floor/plasteel,
/area/ruin/space/has_grav/cloning_lab)
"TU" = (
/obj/structure/fluff/broken_flooring{
	dir = 8;
	icon_state = "plating";
	name = "broken plating"
	},
/obj/structure/lattice,
/obj/item/stack/cable_coil/cut/red,
/turf/template_noop,
/area/ruin/space/has_grav/cloning_lab)
"US" = (
/obj/structure/fluff/broken_flooring{
	dir = 8;
	icon_state = "plating";
	name = "broken plating"
	},
/obj/structure/lattice,
/turf/template_noop,
/area/ruin/space/has_grav/cloning_lab)
"WH" = (
/obj/effect/decal/cleanable/dirt,
/obj/machinery/atmospherics/pipe/simple/supply/hidden/layer2{
	dir = 4
	},
/obj/machinery/atmospherics/pipe/simple/scrubbers/hidden/layer4{
	dir = 8
	},
/turf/open/floor/plasteel/white,
/area/ruin/space/has_grav/cloning_lab)
"WO" = (
/obj/machinery/atmospherics/components/unary/vent_scrubber/on/layer4{
	dir = 1
	},
/turf/open/floor/plating/airless{
	icon_state = "platingdmg2"
	},
/area/ruin/space/has_grav/cloning_lab)
"XI" = (
/obj/effect/decal/cleanable/dirt,
/obj/machinery/atmospherics/components/binary/valve/layer2{
	dir = 4
	},
/obj/machinery/atmospherics/pipe/simple/scrubbers/hidden/layer4{
	dir = 8
	},
/turf/open/floor/plasteel/white,
/area/ruin/space/has_grav/cloning_lab)
"Ys" = (
/obj/structure/table/glass,
/obj/item/storage/box/syringes,
/obj/effect/decal/cleanable/dirt,
/turf/open/floor/plasteel/white,
/area/ruin/space/has_grav/cloning_lab)
"YX" = (
/obj/structure/cable,
/obj/machinery/power/apc/auto_name/south{
	start_charge = 5
	},
/obj/effect/decal/cleanable/dirt,
/turf/open/floor/plasteel/white,
/area/ruin/space/has_grav/cloning_lab)
"Zy" = (
/obj/structure/table/glass,
/obj/machinery/light,
/obj/structure/bedsheetbin,
/obj/effect/decal/cleanable/dirt,
/obj/machinery/atmospherics/pipe/simple/scrubbers/hidden/layer4{
	dir = 5
	},
/turf/open/floor/plasteel/white,
/area/ruin/space/has_grav/cloning_lab)

(1,1,1) = {"
jZ
jZ
jZ
jZ
jZ
jZ
jZ
jZ
jZ
jZ
jZ
"}
(2,1,1) = {"
jZ
jZ
Me
GK
GK
GK
PT
jZ
jZ
jZ
jZ
"}
(3,1,1) = {"
jZ
jZ
aA
li
rE
NV
aA
jZ
jZ
jZ
jZ
"}
(4,1,1) = {"
jZ
jZ
aA
qW
xK
Sa
aA
jZ
jZ
jZ
jZ
"}
(5,1,1) = {"
jZ
jZ
Ef
gO
Hn
Lu
Ef
jZ
jZ
jZ
jZ
"}
(6,1,1) = {"
jZ
jZ
Ef
vp
SO
Ef
Ef
jZ
jZ
jZ
jZ
"}
(7,1,1) = {"
jZ
jZ
jZ
vp
uV
vp
jZ
jZ
jZ
jZ
jZ
"}
(8,1,1) = {"
jZ
jZ
Ef
Ef
fn
vp
vp
jZ
jZ
jZ
jZ
"}
(9,1,1) = {"
jZ
vp
vp
Ff
FK
aK
Ih
jZ
jZ
jZ
jZ
"}
(10,1,1) = {"
jZ
Ih
oe
eF
XI
OG
EF
jZ
jZ
jZ
jZ
"}
(11,1,1) = {"
jZ
EF
An
hM
WH
Qk
Ef
jZ
jZ
jZ
jZ
"}
(12,1,1) = {"
jZ
Ef
vn
LT
Bn
Zy
vp
jZ
jZ
jZ
jZ
"}
(13,1,1) = {"
jZ
vp
uu
GP
qE
qR
Ih
jZ
jZ
jZ
jZ
"}
(14,1,1) = {"
jZ
vp
Lh
Dg
MN
RI
EF
jZ
jZ
jZ
jZ
"}
(15,1,1) = {"
jZ
vp
wb
Dg
DR
Ys
Ef
jZ
jZ
gh
jZ
"}
(16,1,1) = {"
jZ
Ef
dj
im
Ko
YX
Ef
cu
jZ
jZ
jZ
"}
(17,1,1) = {"
jZ
Ef
ui
Ow
jo
mI
vp
jZ
jZ
cu
jZ
"}
(18,1,1) = {"
jZ
Ih
bt
Fy
GS
aS
Ef
jZ
Hd
jZ
jZ
"}
(19,1,1) = {"
jZ
EF
KP
mK
Nm
WO
TU
jZ
jZ
jZ
gh
"}
(20,1,1) = {"
jZ
Ef
kk
aS
dg
dl
Hd
Hd
gh
cu
jZ
"}
(21,1,1) = {"
jZ
jZ
vp
GN
US
Hd
Hd
jZ
jZ
jZ
Hd
"}
(22,1,1) = {"
jZ
jZ
jZ
gh
jZ
jZ
jZ
pg
Hd
jZ
jZ
"}
(23,1,1) = {"
jZ
jZ
jZ
Hd
GC
jZ
jZ
jZ
gh
jZ
cu
"}
(24,1,1) = {"
jZ
cu
jZ
jZ
jZ
gh
Hd
jZ
jZ
jZ
jZ
"}
(25,1,1) = {"
jZ
jZ
gh
jZ
jZ
jZ
cu
jZ
cu
jZ
Hd
"}
