//MAP CONVERTED BY dmm2tgm.py THIS HEADER COMMENT PREVENTS RECONVERSION, DO NOT REMOVE
"aa" = (
/turf/open/floor/plating/airless,
/area/ruin/space/has_grav/goat_transport/security)
"ab" = (
/turf/open/floor/plating/airless,
/area/ruin/space/has_grav/goat_transport/crew)
"ac" = (
/turf/template_noop,
/area/ruin/space/has_grav/goat_transport/security)
"ad" = (
/turf/closed/wall/mineral/titanium/nodiagonal,
/area/ruin/space/has_grav/goat_transport/medical)
"ag" = (
/turf/closed/wall/mineral/titanium/survival/nodiagonal,
/area/ruin/space/has_grav/goat_transport/module_1)
"as" = (
/turf/closed/wall/mineral/titanium/nodiagonal,
/area/ruin/space/has_grav/goat_transport/crew)
"aA" = (
/turf/closed/wall/mineral/titanium,
/area/ruin/space/has_grav/goat_transport/engine)
"aI" = (
/obj/effect/spawner/structure/window/survival_pod,
/turf/open/floor/plating,
/area/ruin/space/has_grav/goat_transport/module_2)
"aL" = (
/turf/closed/wall/mineral/titanium,
/area/ruin/space/has_grav/goat_transport/bridge)
"aN" = (
/turf/closed/wall/mineral/titanium/survival,
/area/ruin/space/has_grav/goat_transport/module_1)
"aR" = (
/turf/template_noop,
/area/template_noop)
"aU" = (
/turf/template_noop,
/area/ruin/space/has_grav/goat_transport/bridge)
"aV" = (
/turf/template_noop,
/area/ruin/space/has_grav/goat_transport/module_1)
"aZ" = (
/turf/closed/wall/mineral/titanium,
/area/ruin/space/has_grav/goat_transport/crew)
"bc" = (
/turf/template_noop,
/area/ruin/space/has_grav/goat_transport/medical)
"bg" = (
/turf/template_noop,
/area/ruin/space/has_grav/goat_transport/engine)
"bj" = (
/turf/closed/wall/mineral/titanium,
/area/ruin/space/has_grav/goat_transport/security)
"bm" = (
/turf/closed/wall/mineral/titanium/nodiagonal,
/area/ruin/space/has_grav/goat_transport/storage)
"bo" = (
/turf/template_noop,
/area/ruin/space/has_grav/goat_transport/docking_hall)
"bt" = (
/turf/closed/wall/mineral/titanium/nodiagonal,
/area/ruin/space/has_grav/goat_transport/engine)
"bw" = (
/turf/closed/wall/mineral/titanium/nodiagonal,
/area/ruin/space/has_grav/goat_transport/bridge)
"bA" = (
/turf/closed/wall/mineral/titanium/survival/nodiagonal,
/area/ruin/space/has_grav/goat_transport/module_2)
"bE" = (
/turf/template_noop,
/area/ruin/space/has_grav/goat_transport/storage)
"bG" = (
/turf/closed/wall/mineral/titanium/survival,
/area/ruin/space/has_grav/goat_transport/module_2)
"bN" = (
/obj/effect/mob_spawn/human/commander{
	assignedrole = "null";
	mob_gender = "male";
	mob_name = "John Lamario";
	name = "John Lamario"
	},
/obj/effect/decal/cleanable/blood/old,
/obj/item/gun/ballistic/automatic/laser,
/obj/item/paper/crumpled/bloody/goattransport,
/turf/open/floor/mineral/titanium/blue,
/area/template_noop)
"bS" = (
/turf/template_noop,
/area/ruin/space/has_grav/goat_transport/module_2)
"ca" = (
/obj/effect/mob_spawn/human/corpse/nanotrasensoldier,
/obj/effect/decal/cleanable/blood/old,
/obj/item/gun/ballistic/rifle/boltaction,
/turf/open/floor/mineral/titanium,
/area/template_noop)
"ce" = (
/turf/template_noop,
/area/ruin/space/has_grav/goat_transport/crew)
"cf" = (
/obj/effect/spawner/structure/window/survival_pod,
/turf/open/floor/plating,
/area/ruin/space/has_grav/goat_transport/module_1)
"cg" = (
/turf/closed/wall/mineral/titanium/nodiagonal,
/area/ruin/space/has_grav/goat_transport/security)

(1,1,1) = {"
aR
aR
aR
aR
aR
aR
aR
aR
aR
aR
aR
aR
aR
aR
aR
aR
aR
aR
aR
aR
aR
aR
aR
aR
aR
aR
aR
aR
aR
aR
aR
aR
aR
aR
aR
aR
aR
aR
aR
aR
aR
aR
aR
aR
aR
aR
aR
aR
aR
aR
aR
aR
aR
aR
aR
aR
aR
aR
aR
aR
aR
aR
aR
aR
aR
aR
aR
aR
aR
aR
aR
aR
aR
aR
aR
"}
(2,1,1) = {"
aR
aR
aR
aR
aR
aR
aR
aR
aR
aR
aR
aR
aR
aR
aR
aR
aR
aR
aR
aR
aR
aR
aR
aR
aR
aR
aR
aR
aR
aR
aR
aR
aR
aR
aR
aR
aR
aR
aR
aR
aR
aR
aR
aR
aR
aR
aR
aR
aR
aR
aR
aR
aR
aR
aR
aR
aR
aR
aR
aR
aR
aR
aR
aR
aR
aR
aR
aR
aR
aR
aR
aR
aR
bN
aR
"}
(3,1,1) = {"
aR
aR
aR
aR
aR
aR
aR
aR
aR
aR
aR
aR
aR
aR
aR
aR
aR
aR
aR
aR
aR
aR
aR
aR
aR
aR
aR
aR
aR
aR
aR
aR
aR
aR
aR
aR
aR
aR
aR
aR
aR
aR
aR
aR
aR
aR
aR
aR
aR
aR
aR
aR
aR
aR
aR
aR
aR
aR
aR
aR
aR
aR
aR
aR
aR
aR
aR
aR
aR
aR
aR
aR
aR
aR
aR
"}
(4,1,1) = {"
aR
aR
aR
aR
aR
aR
aR
aR
aR
aR
aR
aR
aR
aR
aR
aR
aR
aR
aR
aR
aR
aR
aR
aR
aR
aR
aR
aR
aR
aR
aR
aR
aR
aR
aL
bw
aU
aU
aU
aU
aU
bw
aL
aR
aR
aR
aR
aR
aR
aR
aR
aR
aR
aR
aR
aR
aR
aR
aR
aR
aR
aR
aR
aR
aR
aR
aR
aR
aR
aR
aR
aR
aR
ca
aR
"}
(5,1,1) = {"
aR
aR
aR
aR
aR
aR
aR
aR
aR
aR
aR
aR
aR
aR
aR
aR
aR
aR
aR
aR
aR
aR
aR
aR
aR
aR
aR
aR
aR
aR
aR
aR
aR
aL
bw
aU
aU
aU
aU
aU
aU
aU
bw
aL
aR
aR
aR
aR
aR
aR
aR
aR
aR
aR
aR
aR
aR
aR
aR
aR
aR
aR
aR
aR
aR
aR
aR
aR
aR
aR
aR
aR
aR
aR
aR
"}
(6,1,1) = {"
aR
aR
aR
aR
aR
aR
aR
aR
aR
aR
aR
aR
aR
aR
aR
aR
aR
aR
aR
aR
aR
aR
aR
aR
aR
aR
aR
aR
aR
aR
aR
aR
aL
bw
aU
aU
aU
aU
aU
aU
aU
aU
aU
bw
aL
aR
aR
aR
aR
aR
aR
aR
aR
aR
aR
aR
aR
aR
aR
aR
aR
aR
aR
aR
aR
aR
aR
aR
aR
aR
aR
aR
aR
aR
aR
"}
(7,1,1) = {"
aR
aR
aR
aR
aR
aR
aR
aR
aR
aR
aR
aR
aR
aR
aR
aR
aR
aR
aR
aR
aR
aR
aR
aR
aR
aR
aR
aR
aR
aR
aR
aZ
bw
aU
aU
aU
aU
aU
aU
aU
aU
aU
aU
aU
bw
bj
aR
aR
aR
aR
aR
aR
aR
aR
aR
aR
aR
aR
aR
aR
aR
aR
aR
aR
aR
aR
aR
aR
aR
aR
aR
aR
aR
aR
aR
"}
(8,1,1) = {"
aR
aR
aR
aR
aR
aR
aR
aR
aR
aR
aR
aR
aR
aR
aR
aR
aR
aR
aR
aR
aR
aR
aR
aR
aR
aR
aR
aR
aR
aR
aZ
as
aU
aU
aU
aU
aU
aU
aU
aU
aU
aU
aU
aU
aU
cg
bj
aR
aR
aR
aR
aR
aR
aR
aR
aR
aR
aR
aR
aR
aR
aR
aR
aR
aR
aR
aR
aR
aR
aR
aR
aR
aR
aR
aR
"}
(9,1,1) = {"
aR
aR
aR
aR
aR
aR
aR
aR
aR
aR
aR
aR
aR
aR
aR
aR
aR
aR
aR
aR
aR
aR
aR
aR
aR
aR
aR
aR
aR
aZ
as
ce
aU
aU
aU
aU
aU
aU
aU
aU
aU
aU
aU
aU
aU
ac
cg
bj
aR
aR
aR
aR
aR
aR
aR
aR
aR
aR
aR
aR
aR
aR
aR
aR
aR
aR
aR
aR
aR
aR
aR
aR
aR
aR
aR
"}
(10,1,1) = {"
aR
aR
aR
aR
aR
aR
aR
aR
aR
aR
aR
aR
aR
aR
aR
aR
aR
aR
aR
aR
aR
aR
aR
aR
aR
aR
aR
aR
aZ
as
ce
ce
ce
ce
ce
ce
bo
bo
bo
bo
bo
ac
ac
ac
ac
ac
ac
cg
bj
aR
aR
aR
aR
aR
aR
aR
aR
aR
aR
aR
aR
aR
aR
aR
aR
aR
aR
aR
aR
aR
aR
aR
aR
aR
aR
"}
(11,1,1) = {"
aR
aR
aR
aR
aR
aR
aR
aR
aR
aR
aR
aR
aR
aR
aR
aR
aR
aR
aR
aR
aR
aR
aR
aR
aR
aR
aR
aZ
as
ce
ce
ce
ce
ce
ce
ce
bo
bo
bo
bo
bo
ac
ac
ac
ac
ac
ac
ac
cg
bj
aR
aR
aR
aR
aR
aR
aR
aR
aR
aR
aR
aR
aR
aR
aR
aR
aR
aR
aR
aR
aR
aR
aR
aR
aR
"}
(12,1,1) = {"
aR
aR
aR
aR
aR
aR
aR
aR
aR
aR
aR
aR
aR
aR
aR
aR
aR
aR
aR
aR
aR
aR
aR
aR
aR
aR
aZ
as
ce
ce
ce
ce
ce
ce
ce
ce
bo
bo
bo
bo
bo
ac
ac
ac
ac
ac
ac
ac
ac
cg
bj
aR
aR
aR
aR
aR
aR
aR
aR
aR
aR
aR
aR
aR
aR
aR
aR
aR
aR
aR
aR
aR
aR
aR
aR
"}
(13,1,1) = {"
aR
aR
aR
aR
aR
aR
aR
aR
aR
aR
aR
aR
aR
aR
aR
aR
aR
aR
aR
aR
aR
aR
aR
aR
aR
aZ
as
ce
ce
ce
ce
ce
ce
ce
ce
ce
bo
bo
bo
bo
bo
ac
ac
ac
ac
ac
ac
ac
ac
ac
cg
bj
aR
aR
aR
aR
aR
aR
aR
aR
aR
aR
aR
aR
aR
aR
aR
aR
aR
aR
aR
aR
aR
aR
aR
"}
(14,1,1) = {"
aR
aR
aR
aR
aR
aR
aR
aR
aR
aR
aR
aR
aR
aR
aR
aR
aR
aR
aR
aR
aR
aR
aR
aR
aR
as
ce
ce
ce
ce
ce
ce
ce
ce
ce
ce
bo
bo
bo
bo
bo
ac
ac
ac
ac
ac
ac
ac
ac
ac
ac
cg
aR
aR
aR
aR
aR
aR
aR
aR
aR
aR
aR
aR
aR
aR
aR
aR
aR
aR
aR
aR
aR
aR
aR
"}
(15,1,1) = {"
aR
aR
aR
aR
aR
aR
aR
aR
aR
aR
aR
aR
aR
aR
aR
aR
aR
aR
aR
aR
aR
aR
aR
aR
aR
as
ce
ce
ce
ce
ce
ce
ce
ce
ce
ce
bo
bo
bo
bo
bo
ac
ac
ac
ac
ac
ac
ac
ac
ac
ac
cg
aR
aR
aR
aR
aR
aR
aR
aR
aR
aR
aR
aR
aR
aR
aR
aR
aR
aR
aR
aR
aR
aR
aR
"}
(16,1,1) = {"
aR
aR
aR
aR
aR
aR
aR
aR
aR
aR
aR
aR
aR
aR
aR
aR
aR
aR
aR
aR
aR
aR
aR
aR
aR
as
ce
ce
ce
ce
ce
ce
ce
ce
ce
ce
bo
bo
bo
bo
bo
ac
ac
ac
ac
ac
ac
ac
ac
ac
ac
cg
aR
aR
aR
aR
aR
aR
aR
aR
aR
aR
aR
aR
aR
aR
aR
aR
aR
aR
aR
aR
aR
aR
aR
"}
(17,1,1) = {"
aR
aR
aR
aR
aR
aR
aR
aR
aR
aR
aR
aR
aR
aR
aR
aR
aR
aR
aR
aR
aR
aR
aR
aR
aR
as
ce
ce
ce
ce
ce
ce
ce
ce
ce
ce
bo
bo
bo
bo
bo
ac
ac
ac
ac
ac
ac
ac
ac
ac
ac
cg
aR
aR
aR
aR
aR
aR
aR
aR
aR
aR
aR
aR
aR
aR
aR
aR
aR
aR
aR
aR
aR
aR
aR
"}
(18,1,1) = {"
aR
aR
aR
aR
aR
aR
aR
aR
aR
aR
aR
aR
aR
aR
aR
aR
aR
aR
aR
aR
aR
aR
aR
aR
aR
as
ce
ce
ce
ce
ce
ce
ce
ce
ce
ce
bo
bo
bo
bo
bo
ac
ac
ac
ac
ac
ac
ac
ac
ac
ac
cg
aR
aR
aR
aR
aR
aR
aR
aR
aR
aR
aR
aR
aR
aR
aR
aR
aR
aR
aR
aR
aR
aR
aR
"}
(19,1,1) = {"
aR
aR
aR
aR
aR
aR
aR
aR
aR
aR
aR
aR
aR
aR
aR
aR
aR
aR
aR
aR
aR
aR
aR
aR
aR
as
ce
ce
ce
ce
ce
ce
ce
ce
ce
ce
bo
bo
bo
bo
bo
ac
ac
ac
ac
ac
ac
ac
ac
ac
ac
cg
aR
aR
aR
aR
aR
aR
aR
aR
aR
aR
aR
aR
aR
aR
aR
aR
aR
aR
aR
aR
aR
aR
aR
"}
(20,1,1) = {"
aR
aR
aR
aR
aR
aR
aR
aR
aR
aR
aR
aR
aR
aR
aR
aR
aR
aR
aR
aR
aR
aR
aR
aR
aR
as
ce
ce
ce
ce
ce
ce
ce
ce
ce
ce
bo
bo
bo
bo
bo
ac
ac
ac
ac
ac
ac
ac
ac
ac
ac
cg
aR
aR
aR
aR
aR
aR
aR
aR
aR
aR
aR
aR
aR
aR
aR
aR
aR
aR
aR
aR
aR
aR
aR
"}
(21,1,1) = {"
aR
aR
aR
aR
aR
aR
aR
aR
aR
aR
aR
aR
aR
aR
aR
aR
aR
aR
aR
aR
aR
aR
aR
aR
aR
as
ce
ce
ce
ce
ce
ce
ce
ce
ce
ce
bo
bo
bo
bo
bo
ac
ac
ac
ac
ac
ac
ac
ac
ac
ac
cg
aR
aR
aR
aR
aR
aR
aR
aR
aR
aR
aR
aR
aR
aR
aR
aR
aR
aR
aR
aR
aR
aR
aR
"}
(22,1,1) = {"
aR
aR
aR
aR
aR
aR
aR
aR
aR
aR
aR
aR
aR
aR
aR
aR
aR
aR
aR
aR
aR
aR
aR
aR
aR
as
ce
ce
ce
ce
ce
ce
ce
ce
ce
ce
bo
bo
bo
bo
bo
ac
ac
ac
ac
ac
ac
ac
ac
ac
ac
cg
aR
aR
aR
aR
aR
aR
aR
aR
aR
aR
aR
aR
aR
aR
aR
aR
aR
aR
aR
aR
aR
aR
aR
"}
(23,1,1) = {"
aR
aR
aR
aR
aR
aR
aR
aR
aR
aR
aR
aR
aR
aR
aR
aR
aR
aR
aR
aR
aR
aR
aR
aR
aR
as
ce
ce
ce
ce
ce
ce
ce
ce
ce
ce
bo
bo
bo
bo
bo
ac
ac
ac
ac
ac
ac
ac
ac
ac
ac
cg
aR
aR
aR
aR
aR
aR
aR
aR
aR
aR
aR
aR
aR
aR
aR
aR
aR
aR
aR
aR
aR
aR
aR
"}
(24,1,1) = {"
aR
aR
aR
aR
aR
aR
aR
aR
aR
aR
aR
aR
aR
aR
aR
aR
aR
aR
aR
aR
aR
aR
aR
aR
aR
as
ce
ce
ce
ce
ce
ce
ce
ce
ce
ce
bo
bo
bo
bo
bo
ac
ac
ac
ac
ac
ac
ac
ac
ac
ac
cg
aR
aR
aR
aR
aR
aR
aR
aR
aR
aR
aR
aR
aR
aR
aR
aR
aR
aR
aR
aR
aR
aR
aR
"}
(25,1,1) = {"
aR
aR
aR
aR
aR
aR
aR
aR
aR
aR
aR
aR
aR
aR
aR
aR
aR
aR
aR
aR
aR
aR
aR
aR
aR
as
ce
ce
ce
ce
ce
ce
ce
ce
ce
ce
bo
bo
bo
bo
bo
ac
ac
ac
ac
ac
ac
ac
ac
ac
ac
cg
aR
aR
aR
aR
aR
aR
aR
aR
aR
aR
aR
aR
aR
aR
aR
aR
aR
aR
aR
aR
aR
aR
aR
"}
(26,1,1) = {"
aR
aR
aR
aR
aR
aR
aR
aR
aR
aR
aR
aR
aR
aR
aR
aR
aR
aR
aR
aR
aR
aR
aR
aR
aR
as
ce
ce
ce
ce
ce
ce
ce
ce
ce
ce
bo
bo
bo
bo
bo
ac
ac
ac
ac
ac
ac
ac
ac
ac
ac
cg
aR
aR
aR
aR
aR
aR
aR
aR
aR
aR
aR
aR
aR
aR
aR
aR
aR
aR
aR
aR
aR
aR
aR
"}
(27,1,1) = {"
aR
aR
aR
aR
aR
aR
aR
aR
aR
aR
aR
aR
aR
aR
aR
aR
aR
aR
aR
aR
aR
aR
aR
aR
aR
ab
aR
aR
aR
aR
aR
aR
aR
aR
aR
aR
bo
bo
bo
bo
bo
aR
aR
aR
aR
aR
aR
aR
aR
aR
aR
aa
aR
aR
aR
aR
aR
aR
aR
aR
aR
aR
aR
aR
aR
aR
aR
aR
aR
aR
aR
aR
aR
aR
aR
"}
(28,1,1) = {"
aR
aR
aR
aR
aR
aR
aR
aR
aR
aR
aR
aR
aR
aR
aR
aR
aR
aR
aR
aR
aR
aR
aR
aR
aR
ab
aR
aN
ag
ag
ag
ag
ag
ag
aN
aR
bo
bo
bo
bo
bo
aR
bG
bA
bA
bA
bA
bA
bA
bG
aR
aa
aR
aR
aR
aR
aR
aR
aR
aR
aR
aR
aR
aR
aR
aR
aR
aR
aR
aR
aR
aR
aR
aR
aR
"}
(29,1,1) = {"
aR
aR
aR
aR
aR
aR
aR
aR
aR
aR
aR
aR
aR
aR
aR
aR
aR
aR
aR
aR
aR
aR
aR
aR
aR
ab
aR
ag
aV
aV
aV
aV
aV
aV
ag
aR
bo
bo
bo
bo
bo
aR
bA
bS
bS
bS
bS
bS
bS
bA
aR
aa
aR
aR
aR
aR
aR
aR
aR
aR
aR
aR
aR
aR
aR
aR
aR
aR
aR
aR
aR
aR
aR
aR
aR
"}
(30,1,1) = {"
aR
aR
aR
aR
aR
aR
aR
aR
aR
aR
aR
aR
aR
aR
aR
aR
aR
aR
aR
aR
aR
aR
aR
aR
aR
ab
aR
ag
aV
aV
aV
aV
aV
aV
ag
ag
bo
bo
bo
bo
bo
bA
bA
bS
bS
bS
bS
bS
bS
bA
aR
aa
aR
aR
aR
aR
aR
aR
aR
aR
aR
aR
aR
aR
aR
aR
aR
aR
aR
aR
aR
aR
aR
aR
aR
"}
(31,1,1) = {"
aR
aR
aR
aR
aR
aR
aR
aR
aR
aR
aR
aR
aR
aR
aR
aR
aR
aR
aR
aR
aR
aR
aR
aR
aR
ab
aR
ag
aV
aV
aV
aV
aV
aV
aV
aV
bo
bo
bo
bo
bo
bS
bS
bS
bS
bS
bS
bS
bS
bA
aR
aa
aR
aR
aR
aR
aR
aR
aR
aR
aR
aR
aR
aR
aR
aR
aR
aR
aR
aR
aR
aR
aR
aR
aR
"}
(32,1,1) = {"
aR
aR
aR
aR
aR
aR
aR
aR
aR
aR
aR
aR
aR
aR
aR
aR
aR
aR
aR
aR
aR
aR
aR
aR
aR
ab
aR
ag
aV
aV
aV
aV
aV
aV
ag
ag
bo
bo
bo
bo
bo
bA
bA
bS
bS
bS
bS
bS
bS
bA
aR
aa
aR
aR
aR
aR
aR
aR
aR
aR
aR
aR
aR
aR
aR
aR
aR
aR
aR
aR
aR
aR
aR
aR
aR
"}
(33,1,1) = {"
aR
aR
aR
aR
aR
aR
aR
aR
aR
aR
aR
aR
aR
aR
aR
aR
aR
aR
aR
aR
aR
aR
aR
aR
aR
ab
aR
ag
aV
aV
aV
aV
aV
aV
ag
aR
bo
bo
bo
bo
bo
aR
bA
bS
bS
bS
bS
bS
bS
bA
aR
aa
aR
aR
aR
aR
aR
aR
aR
aR
aR
aR
aR
aR
aR
aR
aR
aR
aR
aR
aR
aR
aR
aR
aR
"}
(34,1,1) = {"
aR
aR
aR
aR
aR
aR
aR
aR
aR
aR
aR
aR
aR
aR
aR
aR
aR
aR
aR
aR
aR
aR
aR
aR
aR
ab
aR
ag
aV
aV
aV
aV
aV
aV
cf
aR
bo
bo
bo
bo
bo
aR
aI
bS
bS
bS
bS
bS
bS
bA
aR
aa
aR
aR
aR
aR
aR
aR
aR
aR
aR
aR
aR
aR
aR
aR
aR
aR
aR
aR
aR
aR
aR
aR
aR
"}
(35,1,1) = {"
aR
aR
aR
aR
aR
aR
aR
aR
aR
aR
aR
aR
aR
aR
aR
aR
aR
aR
aR
aR
aR
aR
aR
aR
aR
ab
aR
ag
aV
aV
aV
aV
aV
aV
cf
aR
bo
bo
bo
bo
bo
aR
aI
bS
bS
bS
bS
bS
bS
bA
aR
aa
aR
aR
aR
aR
aR
aR
aR
aR
aR
aR
aR
aR
aR
aR
aR
aR
aR
aR
aR
aR
aR
aR
aR
"}
(36,1,1) = {"
aR
aR
aR
aR
aR
aR
aR
aR
aR
aR
aR
aR
aR
aR
aR
aR
aR
aR
aR
aR
aR
aR
aR
aR
aR
ab
aR
ag
aV
aV
aV
aV
aV
aV
cf
aR
bo
bo
bo
bo
bo
aR
aI
bS
bS
bS
bS
bS
bS
bA
aR
aa
aR
aR
aR
aR
aR
aR
aR
aR
aR
aR
aR
aR
aR
aR
aR
aR
aR
aR
aR
aR
aR
aR
aR
"}
(37,1,1) = {"
aR
aR
aR
aR
aR
aR
aR
aR
aR
aR
aR
aR
aR
aR
aR
aR
aR
aR
aR
aR
aR
aR
aR
aR
aR
ab
aR
ag
aV
aV
aV
aV
aV
aV
cf
aR
bo
bo
bo
bo
bo
aR
aI
bS
bS
bS
bS
bS
bS
bA
aR
aa
aR
aR
aR
aR
aR
aR
aR
aR
aR
aR
aR
aR
aR
aR
aR
aR
aR
aR
aR
aR
aR
aR
aR
"}
(38,1,1) = {"
aR
aR
aR
aR
aR
aR
aR
aR
aR
aR
aR
aR
aR
aR
aR
aR
aR
aR
aR
aR
aR
aR
aR
aR
aR
ab
aR
ag
aV
aV
aV
aV
aV
aV
cf
aR
bo
bo
bo
bo
bo
aR
aI
bS
bS
bS
bS
bS
bS
bA
aR
aa
aR
aR
aR
aR
aR
aR
aR
aR
aR
aR
aR
aR
aR
aR
aR
aR
aR
aR
aR
aR
aR
aR
aR
"}
(39,1,1) = {"
aR
aR
aR
aR
aR
aR
aR
aR
aR
aR
aR
aR
aR
aR
aR
aR
aR
aR
aR
aR
aR
aR
aR
aR
aR
ab
aR
ag
aV
aV
aV
aV
aV
aV
cf
aR
bo
bo
bo
bo
bo
aR
aI
bS
bS
bS
bS
bS
bS
bA
aR
aa
aR
aR
aR
aR
aR
aR
aR
aR
aR
aR
aR
aR
aR
aR
aR
aR
aR
aR
aR
aR
aR
aR
aR
"}
(40,1,1) = {"
aR
aR
aR
aR
aR
aR
aR
aR
aR
aR
aR
aR
aR
aR
aR
aR
aR
aR
aR
aR
aR
aR
aR
aR
aR
ab
aR
ag
aV
aV
aV
aV
aV
aV
cf
aR
bo
bo
bo
bo
bo
aR
aI
bS
bS
bS
bS
bS
bS
bA
aR
aa
aR
aR
aR
aR
aR
aR
aR
aR
aR
aR
aR
aR
aR
aR
aR
aR
aR
aR
aR
aR
aR
aR
aR
"}
(41,1,1) = {"
aR
aR
aR
aR
aR
aR
aR
aR
aR
aR
aR
aR
aR
aR
aR
aR
aR
aR
aR
aR
aR
aR
aR
aR
aR
ab
aR
ag
aV
aV
aV
aV
aV
aV
cf
aR
bo
bo
bo
bo
bo
aR
aI
bS
bS
bS
bS
bS
bS
bA
aR
aa
aR
aR
aR
aR
aR
aR
aR
aR
aR
aR
aR
aR
aR
aR
aR
aR
aR
aR
aR
aR
aR
aR
aR
"}
(42,1,1) = {"
aR
aR
aR
aR
aR
aR
aR
aR
aR
aR
aR
aR
aR
aR
aR
aR
aR
aR
aR
aR
aR
aR
aR
aR
aR
ab
aR
ag
aV
aV
aV
aV
aV
aV
cf
aR
bo
bo
bo
bo
bo
aR
aI
bS
bS
bS
bS
bS
bS
bA
aR
aa
aR
aR
aR
aR
aR
aR
aR
aR
aR
aR
aR
aR
aR
aR
aR
aR
aR
aR
aR
aR
aR
aR
aR
"}
(43,1,1) = {"
aR
aR
aR
aR
aR
aR
aR
aR
aR
aR
aR
aR
aR
aR
aR
aR
aR
aR
aR
aR
aR
aR
aR
aR
aR
ab
aR
ag
aV
aV
aV
aV
aV
aV
cf
aR
bo
bo
bo
bo
bo
aR
aI
bS
bS
bS
bS
bS
bS
bA
aR
aa
aR
aR
aR
aR
aR
aR
aR
aR
aR
aR
aR
aR
aR
aR
aR
aR
aR
aR
aR
aR
aR
aR
aR
"}
(44,1,1) = {"
aR
aR
aR
aR
aR
aR
aR
aR
aR
aR
aR
aR
aR
aR
aR
aR
aR
aR
aR
aR
aR
aR
aR
aR
aR
ab
aR
ag
aV
aV
aV
aV
aV
aV
cf
aR
bo
bo
bo
bo
bo
aR
aI
bS
bS
bS
bS
bS
bS
bA
aR
aa
aR
aR
aR
aR
aR
aR
aR
aR
aR
aR
aR
aR
aR
aR
aR
aR
aR
aR
aR
aR
aR
aR
aR
"}
(45,1,1) = {"
aR
aR
aR
aR
aR
aR
aR
aR
aR
aR
aR
aR
aR
aR
aR
aR
aR
aR
aR
aR
aR
aR
aR
aR
aR
ab
aR
ag
aV
aV
aV
aV
aV
aV
cf
aR
bo
bo
bo
bo
bo
aR
aI
bS
bS
bS
bS
bS
bS
bA
aR
aa
aR
aR
aR
aR
aR
aR
aR
aR
aR
aR
aR
aR
aR
aR
aR
aR
aR
aR
aR
aR
aR
aR
aR
"}
(46,1,1) = {"
aR
aR
aR
aR
aR
aR
aR
aR
aR
aR
aR
aR
aR
aR
aR
aR
aR
aR
aR
aR
aR
aR
aR
aR
aR
ab
aR
ag
aV
aV
aV
aV
aV
aV
cf
aR
bo
bo
bo
bo
bo
aR
aI
bS
bS
bS
bS
bS
bS
bA
aR
aa
aR
aR
aR
aR
aR
aR
aR
aR
aR
aR
aR
aR
aR
aR
aR
aR
aR
aR
aR
aR
aR
aR
aR
"}
(47,1,1) = {"
aR
aR
aR
aR
aR
aR
aR
aR
aR
aR
aR
aR
aR
aR
aR
aR
aR
aR
aR
aR
aR
aR
aR
aR
aR
ab
aR
ag
aV
aV
aV
aV
aV
aV
cf
aR
bo
bo
bo
bo
bo
aR
aI
bS
bS
bS
bS
bS
bS
bA
aR
aa
aR
aR
aR
aR
aR
aR
aR
aR
aR
aR
aR
aR
aR
aR
aR
aR
aR
aR
aR
aR
aR
aR
aR
"}
(48,1,1) = {"
aR
aR
aR
aR
aR
aR
aR
aR
aR
aR
aR
aR
aR
aR
aR
aR
aR
aR
aR
aR
aR
aR
aR
aR
aR
ab
aR
ag
aV
aV
aV
aV
aV
aV
ag
aR
bo
bo
bo
bo
bo
aR
bA
bS
bS
bS
bS
bS
bS
bA
aR
aa
aR
aR
aR
aR
aR
aR
aR
aR
aR
aR
aR
aR
aR
aR
aR
aR
aR
aR
aR
aR
aR
aR
aR
"}
(49,1,1) = {"
aR
aR
aR
aR
aR
aR
aR
aR
aR
aR
aR
aR
aR
aR
aR
aR
aR
aR
aR
aR
aR
aR
aR
aR
aR
ab
aR
ag
aV
aV
aV
aV
aV
aV
ag
ag
bo
bo
bo
bo
bo
bA
bA
bS
bS
bS
bS
bS
bS
bA
aR
aa
aR
aR
aR
aR
aR
aR
aR
aR
aR
aR
aR
aR
aR
aR
aR
aR
aR
aR
aR
aR
aR
aR
aR
"}
(50,1,1) = {"
aR
aR
aR
aR
aR
aR
aR
aR
aR
aR
aR
aR
aR
aR
aR
aR
aR
aR
aR
aR
aR
aR
aR
aR
aR
ab
aR
ag
aV
aV
aV
aV
aV
aV
aV
aV
bo
bo
bo
bo
bo
bS
bS
bS
bS
bS
bS
bS
bS
bA
aR
aa
aR
aR
aR
aR
aR
aR
aR
aR
aR
aR
aR
aR
aR
aR
aR
aR
aR
aR
aR
aR
aR
aR
aR
"}
(51,1,1) = {"
aR
aR
aR
aR
aR
aR
aR
aR
aR
aR
aR
aR
aR
aR
aR
aR
aR
aR
aR
aR
aR
aR
aR
aR
aR
ab
aR
ag
aV
aV
aV
aV
aV
aV
ag
ag
bo
bo
bo
bo
bo
bA
bA
bS
bS
bS
bS
bS
bS
bA
aR
aa
aR
aR
aR
aR
aR
aR
aR
aR
aR
aR
aR
aR
aR
aR
aR
aR
aR
aR
aR
aR
aR
aR
aR
"}
(52,1,1) = {"
aR
aR
aR
aR
aR
aR
aR
aR
aR
aR
aR
aR
aR
aR
aR
aR
aR
aR
aR
aR
aR
aR
aR
aR
aR
ab
aR
aN
ag
ag
ag
ag
ag
ag
aN
aR
bo
bo
bo
bo
bo
aR
bG
bA
bA
bA
bA
bA
bA
bG
aR
aa
aR
aR
aR
aR
aR
aR
aR
aR
aR
aR
aR
aR
aR
aR
aR
aR
aR
aR
aR
aR
aR
aR
aR
"}
(53,1,1) = {"
aR
aR
aR
aR
aR
aR
aR
aR
aR
aR
aR
aR
aR
aR
aR
aR
aR
aR
aR
aR
aR
aR
aR
aR
aR
ab
aR
aR
aR
aR
aR
aR
aR
aR
aR
aR
bo
bo
bo
bo
bo
aR
aR
aR
aR
aR
aR
aR
aR
aR
aR
aa
aR
aR
aR
aR
aR
aR
aR
aR
aR
aR
aR
aR
aR
aR
aR
aR
aR
aR
aR
aR
aR
aR
aR
"}
(54,1,1) = {"
aR
aR
aR
aR
aR
aR
aR
aR
aR
aR
aR
aR
aR
aR
aR
aR
aR
aR
aR
aR
aR
aR
aR
aR
aR
ad
bc
bc
bc
bc
bc
bc
bc
bc
bc
bc
bo
bo
bo
bo
bo
bE
bE
bE
bE
bE
bE
bE
bE
bE
bE
bm
aR
aR
aR
aR
aR
aR
aR
aR
aR
aR
aR
aR
aR
aR
aR
aR
aR
aR
aR
aR
aR
aR
aR
"}
(55,1,1) = {"
aR
aR
aR
aR
aR
aR
aR
aR
aR
aR
aR
aR
aR
aR
aR
aR
aR
aR
aR
aR
aR
aR
aR
aR
aR
ad
bc
bc
bc
bc
bc
bc
bc
bc
bc
bc
bo
bo
bo
bo
bo
bE
bE
bE
bE
bE
bE
bE
bE
bE
bE
bm
aR
aR
aR
aR
aR
aR
aR
aR
aR
aR
aR
aR
aR
aR
aR
aR
aR
aR
aR
aR
aR
aR
aR
"}
(56,1,1) = {"
aR
aR
aR
aR
aR
aR
aR
aR
aR
aR
aR
aR
aR
aR
aR
aR
aR
aR
aR
aR
aR
aR
aR
aR
aR
ad
bc
bc
bc
bc
bc
bc
bc
bc
bc
bc
bo
bo
bo
bo
bo
bE
bE
bE
bE
bE
bE
bE
bE
bE
bE
bm
aR
aR
aR
aR
aR
aR
aR
aR
aR
aR
aR
aR
aR
aR
aR
aR
aR
aR
aR
aR
aR
aR
aR
"}
(57,1,1) = {"
aR
aR
aR
aR
aR
aR
aR
aR
aR
aR
aR
aR
aR
aR
aR
aR
aR
aR
aR
aR
aR
aR
aR
aR
aR
ad
bc
bc
bc
bc
bc
bc
bc
bc
bc
bc
bo
bo
bo
bo
bo
bE
bE
bE
bE
bE
bE
bE
bE
bE
bE
bm
aR
aR
aR
aR
aR
aR
aR
aR
aR
aR
aR
aR
aR
aR
aR
aR
aR
aR
aR
aR
aR
aR
aR
"}
(58,1,1) = {"
aR
aR
aR
aR
aR
aR
aR
aR
aR
aR
aR
aR
aR
aR
aR
aR
aR
aR
aA
aA
aR
aR
aR
aR
aR
ad
bc
bc
bc
bc
bc
bc
bc
bc
bc
bc
bo
bo
bo
bo
bo
bE
bE
bE
bE
bE
bE
bE
bE
bE
bE
bm
aR
aR
aR
aR
aR
aA
aA
aR
aR
aR
aR
aR
aR
aR
aR
aR
aR
aR
aR
aR
aR
aR
aR
"}
(59,1,1) = {"
aR
aR
aR
aR
aR
aR
aR
aR
aR
aR
aR
aR
aR
aR
aR
aR
aR
aA
bt
bt
aA
aR
aR
aR
aR
ad
bc
bc
bc
bc
bc
bc
bc
bc
bc
bc
bo
bo
bo
bo
bo
bE
bE
bE
bE
bE
bE
bE
bE
bE
bE
bm
aR
aR
aR
aR
aA
bt
bt
aA
aR
aR
aR
aR
aR
aR
aR
aR
aR
aR
aR
aR
aR
aR
aR
"}
(60,1,1) = {"
aR
aR
aR
aR
aR
aR
aR
aR
aR
aR
aR
aR
aR
aR
aR
aR
aA
bt
bt
bt
bt
aA
aR
aR
aR
ad
bc
bc
bc
bc
bc
bc
bc
bc
bc
bc
bo
bo
bo
bo
bo
bE
bE
bE
bE
bE
bE
bE
bE
bE
bE
bm
aR
aR
aR
aA
bt
bt
bt
bt
aA
aR
aR
aR
aR
aR
aR
aR
aR
aR
aR
aR
aR
aR
aR
"}
(61,1,1) = {"
aR
aR
aR
aR
aR
aR
aR
aR
aR
aR
aR
aR
aR
aR
aR
aR
bt
bg
bg
bg
bg
bt
bg
bg
bg
ad
bc
bc
bc
bc
bc
bc
bc
bc
bc
bc
bo
bo
bo
bo
bo
bE
bE
bE
bE
bE
bE
bE
bE
bE
bE
bm
bg
bg
bg
bt
bg
bg
bg
bg
bt
aR
aR
aR
aR
aR
aR
aR
aR
aR
aR
aR
aR
aR
aR
"}
(62,1,1) = {"
aR
aR
aR
aR
aR
aR
aR
aR
aR
aR
aR
aR
aR
aR
aR
aR
bt
bg
bg
bg
bg
bt
aR
aR
aR
ad
bc
bc
bc
bc
bc
bc
bc
bc
bc
bc
bo
bo
bo
bo
bo
bE
bE
bE
bE
bE
bE
bE
bE
bE
bE
bm
aR
aR
aR
bt
bg
bg
bg
bg
bt
aR
aR
aR
aR
aR
aR
aR
aR
aR
aR
aR
aR
aR
aR
"}
(63,1,1) = {"
aR
aR
aR
aR
aR
aR
aR
aR
aR
aR
aR
aR
aR
aR
aR
aR
bt
bg
bg
bg
bg
bt
aR
aR
aR
ad
bc
bc
bc
bc
bc
bc
bc
bc
bc
bc
bo
bo
bo
bo
bo
bE
bE
bE
bE
bE
bE
bE
bE
bE
bE
bm
aR
aR
aR
bt
bg
bg
bg
bg
bt
aR
aR
aR
aR
aR
aR
aR
aR
aR
aR
aR
aR
aR
aR
"}
(64,1,1) = {"
aR
aR
aR
aR
aR
aR
aR
aR
aR
aR
aR
aR
aR
aR
aR
aR
bt
bg
bg
bg
bg
bt
aR
aR
aR
ad
bc
bc
bc
bc
bc
bc
bc
bc
bc
bc
bo
bo
bo
bo
bo
bE
bE
bE
bE
bE
bE
bE
bE
bE
bE
bm
aR
aR
aR
bt
bg
bg
bg
bg
bt
aR
aR
aR
aR
aR
aR
aR
aR
aR
aR
aR
aR
aR
aR
"}
(65,1,1) = {"
aR
aR
aR
aR
aR
aR
aR
aR
aR
aR
aR
aR
aR
aR
aR
aR
bt
bg
bg
bg
bg
bt
aR
aR
aR
bt
bg
bg
bg
bg
bg
bg
bg
bg
bg
bg
bg
bg
bg
bg
bg
bg
bg
bg
bg
bg
bg
bg
bg
bg
bg
bt
aR
aR
aR
bt
bg
bg
bg
bg
bt
aR
aR
aR
aR
aR
aR
aR
aR
aR
aR
aR
aR
aR
aR
"}
(66,1,1) = {"
aR
aR
aR
aR
aR
aR
aR
aR
aR
aR
aR
aR
aR
aR
aR
aR
bt
bg
bg
bg
bg
bt
bg
bg
bg
bg
bg
bg
bg
bg
bg
bg
bg
bg
bg
bg
bg
bg
bg
bg
bg
bg
bg
bg
bg
bg
bg
bg
bg
bg
bg
bg
bg
bg
bg
bt
bg
bg
bg
bg
bt
aR
aR
aR
aR
aR
aR
aR
aR
aR
aR
aR
aR
aR
aR
"}
(67,1,1) = {"
aR
aR
aR
aR
aR
aR
aR
aR
aR
aR
aR
aR
aR
aR
aR
aR
bt
bg
bg
bg
bg
bg
bg
bg
bg
bg
bg
bg
bg
bg
bg
bg
bg
bg
bg
bg
bg
bg
bg
bg
bg
bg
bg
bg
bg
bg
bg
bg
bg
bg
bg
bg
bg
bg
bg
bg
bg
bg
bg
bg
bt
aR
aR
aR
aR
aR
aR
aR
aR
aR
aR
aR
aR
aR
aR
"}
(68,1,1) = {"
aR
aR
aR
aR
aR
aR
aR
aR
aR
aR
aR
aR
aR
aR
aR
aR
bt
bg
bg
bg
bg
bt
bg
bg
bg
bt
bg
bg
bg
bg
bg
bg
bg
bg
bg
bg
bg
bg
bg
bg
bg
bg
bg
bg
bg
bg
bg
bg
bg
bg
bg
bt
bg
bg
bg
bt
bg
bg
bg
bg
bt
aR
aR
aR
aR
aR
aR
aR
aR
aR
aR
aR
aR
aR
aR
"}
(69,1,1) = {"
aR
aR
aR
aR
aR
aR
aR
aR
aR
aR
aR
aR
aR
aR
aR
aR
bt
bg
bg
bg
bg
bt
aR
aR
aR
bt
bg
bg
bg
bg
bg
bg
bg
bg
bg
bg
bg
bg
bg
bg
bg
bg
bg
bg
bg
bg
bg
bg
bg
bg
bg
bt
aR
aR
aR
bt
bg
bg
bg
bg
bt
aR
aR
aR
aR
aR
aR
aR
aR
aR
aR
aR
aR
aR
aR
"}
(70,1,1) = {"
aR
aR
aR
aR
aR
aR
aR
aR
aR
aR
aR
aR
aR
aR
aR
aR
bt
bg
bg
bg
bg
bt
aR
aR
aR
bt
bg
bg
bg
bg
bg
bg
bg
bg
bg
bg
bg
bg
bg
bg
bg
bg
bg
bg
bg
bg
bg
bg
bg
bg
bg
bt
aR
aR
aR
bt
bg
bg
bg
bg
bt
aR
aR
aR
aR
aR
aR
aR
aR
aR
aR
aR
aR
aR
aR
"}
(71,1,1) = {"
aR
aR
aR
aR
aR
aR
aR
aR
aR
aR
aR
aR
aR
aR
aR
aR
bt
bg
bg
bg
bg
bt
aR
aR
aR
bt
bt
bg
bt
bg
bg
bg
bg
bg
bg
bg
bt
bg
bg
bg
bt
bg
bg
bg
bg
bg
bg
bg
bt
bg
bt
bt
aR
aR
aR
bt
bg
bg
bg
bg
bt
aR
aR
aR
aR
aR
aR
aR
aR
aR
aR
aR
aR
aR
aR
"}
(72,1,1) = {"
aR
aR
aR
aR
aR
aR
aR
aR
aR
aR
aR
aR
aR
aR
aR
aR
bt
bg
bg
bg
bg
bt
aR
aR
aR
aR
bt
bg
bt
bg
bt
bg
bg
bt
bg
bg
bt
bg
bg
bg
bt
bg
bg
bt
bg
bg
bt
bg
bt
bg
bt
aR
aR
aR
aR
bt
bg
bg
bg
bg
bt
aR
aR
aR
aR
aR
aR
aR
aR
aR
aR
aR
aR
aR
aR
"}
(73,1,1) = {"
aR
aR
aR
aR
aR
aR
aR
aR
aR
aR
aR
aR
aR
aR
aR
aR
aR
aR
aR
aR
aR
aR
aR
aR
aR
aR
aR
aR
bt
bg
bt
bg
bg
bt
bg
bg
bt
bg
bg
bg
bt
bg
bg
bt
bg
bg
bt
bg
bt
aR
aR
aR
aR
aR
aR
aR
aR
aR
aR
aR
aR
aR
aR
aR
aR
aR
aR
aR
aR
aR
aR
aR
aR
aR
aR
"}
(74,1,1) = {"
aR
aR
aR
aR
aR
aR
aR
aR
aR
aR
aR
aR
aR
aR
aR
aR
aR
aR
aR
aR
aR
aR
aR
aR
aR
aR
aR
aR
aR
aR
bt
bg
bg
bt
bg
bg
bt
bg
bg
bg
bt
bg
bg
bt
bg
bg
bt
aR
aR
aR
aR
aR
aR
aR
aR
aR
aR
aR
aR
aR
aR
aR
aR
aR
aR
aR
aR
aR
aR
aR
aR
aR
aR
aR
aR
"}
(75,1,1) = {"
aR
aR
aR
aR
aR
aR
aR
aR
aR
aR
aR
aR
aR
aR
aR
aR
aR
aR
aR
aR
aR
aR
aR
aR
aR
aR
aR
aR
aR
aR
aR
aR
aR
aR
aR
aR
aR
aR
aR
aR
aR
aR
aR
aR
aR
aR
aR
aR
aR
aR
aR
aR
aR
aR
aR
aR
aR
aR
aR
aR
aR
aR
aR
aR
aR
aR
aR
aR
aR
aR
aR
aR
aR
aR
aR
"}
