//MAP CONVERTED BY dmm2tgm.py THIS HEADER COMMENT PREVENTS RECONVERSION, DO NOT REMOVE
"aa" = (
/obj/machinery/computer/security{
	dir = 1
	},
/turf/open/floor/plasteel/dark,
/area/shuttle/escape)
"an" = (
/obj/effect/turf_decal/stripes/line,
/obj/machinery/mass_driver{
	id = "emergency_vanguard_cargo"
	},
/turf/open/floor/engine/airless,
/area/shuttle/escape)
"aT" = (
/turf/open/floor/mineral/plastitanium/red/brig,
/area/shuttle/escape)
"bH" = (
/obj/machinery/light{
	dir = 8
	},
/obj/machinery/atmospherics/components/unary/tank/oxygen{
	dir = 1
	},
/turf/open/floor/plasteel/white,
/area/shuttle/escape)
"bZ" = (
/obj/structure/tank_dispenser/oxygen,
/turf/open/floor/plasteel,
/area/shuttle/escape)
"cD" = (
/turf/closed/wall/mineral/plastitanium,
/area/shuttle/escape)
"dd" = (
/obj/machinery/door/airlock/security/glass{
	name = "Holding Cell";
	req_access_txt = "2"
	},
/obj/machinery/door/firedoor/border_only,
/turf/open/floor/mineral/plastitanium/red/brig,
/area/shuttle/escape)
"dn" = (
/obj/machinery/light{
	dir = 4
	},
/turf/open/floor/plasteel,
/area/shuttle/escape)
"dp" = (
/obj/effect/turf_decal/stripes/corner,
/turf/open/floor/plasteel,
/area/shuttle/escape)
"eq" = (
/obj/machinery/door/firedoor/border_only{
	dir = 4
	},
/obj/machinery/door/firedoor/border_only{
	dir = 8
	},
/turf/open/floor/plasteel,
/area/shuttle/escape)
"er" = (
/obj/machinery/atmospherics/pipe/simple/supply/hidden/layer2{
	dir = 5
	},
/obj/machinery/atmospherics/pipe/simple/scrubbers/hidden/layer4{
	dir = 5
	},
/turf/open/floor/plasteel,
/area/shuttle/escape)
"fc" = (
/mob/living/simple_animal/bot/medbot{
	name = "\improper emergency medibot";
	pixel_x = -3;
	pixel_y = 2;
	desc = "A little medical robot. He looks somewhat overwhelmed."
	},
/turf/open/floor/plasteel/white,
/area/shuttle/escape)
"fD" = (
/obj/machinery/computer/station_alert{
	dir = 1
	},
/turf/open/floor/plasteel/dark,
/area/shuttle/escape)
"fV" = (
/obj/structure/table/reinforced,
/obj/item/storage/backpack/duffelbag/med/surgery,
/turf/open/floor/plasteel/white,
/area/shuttle/escape)
"gp" = (
/obj/effect/spawner/structure/window/shuttle,
/obj/machinery/door/poddoor/shutters/preopen{
	id = "emergecy_vanguard_windows"
	},
/obj/machinery/door/firedoor/border_only{
	dir = 4
	},
/turf/open/floor/plating,
/area/shuttle/escape)
"hK" = (
/turf/open/floor/plasteel/white,
/area/shuttle/escape)
"in" = (
/obj/structure/chair/comfy/shuttle{
	dir = 4
	},
/obj/machinery/light/small{
	dir = 8
	},
/turf/open/floor/mineral/plastitanium/red/brig,
/area/shuttle/escape)
"iB" = (
/turf/open/floor/plasteel/dark,
/area/shuttle/escape)
"iG" = (
/obj/structure/table/reinforced,
/turf/open/floor/plasteel/white,
/area/shuttle/escape)
"jb" = (
/obj/effect/spawner/structure/window/shuttle,
/obj/machinery/door/firedoor/border_only,
/obj/machinery/door/poddoor/shutters/preopen{
	id = "emergecy_vanguard_windows"
	},
/turf/open/floor/plating,
/area/shuttle/escape)
"jf" = (
/obj/machinery/advanced_airlock_controller{
	dir = 1;
	pixel_y = -24
	},
/obj/machinery/atmospherics/components/binary/dp_vent_pump/layer2{
	dir = 4
	},
/obj/machinery/atmospherics/pipe/simple/scrubbers/hidden/layer4{
	dir = 8
	},
/turf/open/floor/plating,
/area/shuttle/escape)
"jn" = (
/obj/machinery/atmospherics/pipe/simple/supply/hidden/layer2{
	dir = 9
	},
/obj/machinery/atmospherics/pipe/simple/scrubbers/hidden/layer4{
	dir = 9
	},
/turf/open/floor/plasteel,
/area/shuttle/escape)
"ju" = (
/obj/effect/turf_decal/stripes/line{
	dir = 2
	},
/turf/open/floor/plasteel,
/area/shuttle/escape)
"kj" = (
/obj/effect/spawner/structure/window/shuttle,
/obj/machinery/door/firedoor/border_only,
/turf/open/floor/plating,
/area/shuttle/escape)
"kF" = (
/obj/machinery/atmospherics/components/unary/cryo_cell,
/turf/open/floor/plasteel/white,
/area/shuttle/escape)
"mm" = (
/turf/open/floor/engine/airless,
/area/shuttle/escape)
"mv" = (
/obj/machinery/door/airlock/external{
	name = "Cargo Bay"
	},
/obj/machinery/atmospherics/pipe/layer_manifold{
	dir = 4
	},
/obj/effect/mapping_helpers/airlock/locked,
/turf/open/floor/plating,
/area/shuttle/escape)
"mJ" = (
/obj/machinery/light,
/turf/open/floor/engine/airless,
/area/shuttle/escape)
"mO" = (
/obj/effect/spawner/structure/window/shuttle,
/obj/machinery/door/firedoor/border_only,
/obj/machinery/door/firedoor/border_only{
	dir = 4
	},
/obj/machinery/door/poddoor/shutters/preopen{
	id = "emergecy_vanguard_windows"
	},
/turf/open/floor/plating,
/area/shuttle/escape)
"nV" = (
/turf/closed/wall/mineral/titanium,
/area/shuttle/escape)
"oW" = (
/obj/machinery/light{
	dir = 4
	},
/turf/open/floor/engine/airless,
/area/shuttle/escape)
"pc" = (
/obj/machinery/suit_storage_unit/standard_unit,
/obj/machinery/light{
	dir = 4;
	light_color = "#e8eaff"
	},
/turf/open/floor/plasteel,
/area/shuttle/escape)
"pg" = (
/obj/structure/chair/comfy/shuttle,
/obj/effect/turf_decal/bot,
/turf/open/floor/plasteel,
/area/shuttle/escape)
"pu" = (
/obj/structure/chair/comfy/shuttle{
	dir = 8
	},
/obj/effect/turf_decal/bot,
/turf/open/floor/plasteel,
/area/shuttle/escape)
"pN" = (
/obj/structure/closet/supplypod{
	anchored = 0;
	layer = 3
	},
/obj/machinery/conveyor{
	id = "emergency_vanguard_supplypod_loader"
	},
/turf/open/floor/engine/airless,
/area/shuttle/escape)
"pY" = (
/obj/machinery/light{
	dir = 4
	},
/obj/structure/table/reinforced,
/obj/item/storage/firstaid/fire,
/obj/item/storage/firstaid/brute{
	pixel_x = 3;
	pixel_y = 3
	},
/obj/item/storage/firstaid/toxin{
	pixel_x = -4;
	pixel_y = 3
	},
/turf/open/floor/plasteel/white,
/area/shuttle/escape)
"qf" = (
/obj/machinery/door/poddoor/shutters{
	id = "emergency_vanguard_cargo"
	},
/obj/effect/turf_decal/stripes/line,
/obj/effect/turf_decal/stripes/line{
	dir = 1
	},
/turf/open/floor/plating,
/area/shuttle/escape)
"rb" = (
/obj/machinery/advanced_airlock_controller{
	dir = 1;
	pixel_y = -24
	},
/obj/machinery/atmospherics/components/binary/dp_vent_pump/layer2{
	dir = 8
	},
/obj/machinery/atmospherics/pipe/simple/scrubbers/hidden/layer4{
	dir = 8
	},
/turf/open/floor/plating,
/area/shuttle/escape)
"rD" = (
/obj/structure/chair/comfy/shuttle,
/turf/open/floor/plasteel/dark,
/area/shuttle/escape)
"rP" = (
/obj/machinery/door/window/southleft{
	base_state = "right";
	icon_state = "right";
	name = "Security Desk";
	req_access_txt = "1"
	},
/obj/structure/table/reinforced,
/obj/machinery/door/firedoor/border_only{
	dir = 1
	},
/obj/machinery/door/firedoor/border_only,
/turf/open/floor/mineral/plastitanium/red/brig,
/area/shuttle/escape)
"rS" = (
/obj/structure/table/reinforced,
/obj/item/storage/fancy/donut_box,
/obj/item/storage/fancy/donut_box{
	pixel_x = -2;
	pixel_y = 10
	},
/obj/item/storage/fancy/donut_box{
	pixel_x = 4;
	pixel_y = -3
	},
/turf/open/floor/mineral/plastitanium/red/brig,
/area/shuttle/escape)
"tt" = (
/obj/machinery/computer/crew{
	dir = 8
	},
/turf/open/floor/plasteel/dark,
/area/shuttle/escape)
"tH" = (
/obj/item/paper{
	info = "No Homies????"
	},
/obj/structure/closet/crate/secure/loot,
/obj/effect/turf_decal/bot/right,
/turf/open/floor/engine/airless,
/area/shuttle/escape)
"tT" = (
/turf/template_noop,
/area/template_noop)
"uc" = (
/obj/machinery/door/airlock/external/glass,
/obj/machinery/door/firedoor/border_only{
	dir = 4
	},
/obj/machinery/door/firedoor/border_only{
	dir = 8
	},
/turf/open/floor/plating,
/area/shuttle/escape)
"vd" = (
/obj/effect/spawner/structure/window/shuttle,
/obj/machinery/door/poddoor/shutters/preopen{
	id = "emergecy_vanguard_windows"
	},
/turf/open/floor/plating,
/area/shuttle/escape)
"vx" = (
/obj/machinery/suit_storage_unit/standard_unit,
/obj/machinery/light{
	dir = 8;
	light_color = "#e8eaff"
	},
/turf/open/floor/plasteel,
/area/shuttle/escape)
"vD" = (
/obj/structure/closet/crate/secure/loot,
/obj/effect/turf_decal/bot/left,
/turf/open/floor/engine/airless,
/area/shuttle/escape)
"vN" = (
/obj/structure/closet/crate/secure/loot,
/obj/effect/turf_decal/bot/right,
/turf/open/floor/engine/airless,
/area/shuttle/escape)
"vU" = (
/obj/machinery/light{
	dir = 4;
	light_color = "#e8eaff"
	},
/turf/open/floor/plasteel,
/area/shuttle/escape)
"wO" = (
/obj/structure/table/reinforced,
/obj/item/storage/firstaid/o2,
/turf/open/floor/plasteel/white,
/area/shuttle/escape)
"yg" = (
/obj/machinery/vending/wallmed{
	pixel_y = -28
	},
/turf/open/floor/plasteel,
/area/shuttle/escape)
"ym" = (
/obj/structure/table/reinforced,
/turf/open/floor/plasteel/dark,
/area/shuttle/escape)
"yF" = (
/obj/machinery/door/airlock/external/glass{
	name = "NVS Vanguard Secure Transport"
	},
/obj/machinery/door/firedoor/border_only{
	dir = 4
	},
/obj/machinery/door/firedoor/border_only{
	dir = 8
	},
/turf/open/floor/plating,
/area/shuttle/escape)
"zo" = (
/obj/machinery/door/airlock/security/glass{
	name = "Security";
	req_access_txt = "2"
	},
/obj/machinery/door/firedoor/border_only{
	dir = 1
	},
/obj/machinery/door/firedoor/border_only,
/turf/open/floor/mineral/plastitanium/red/brig,
/area/shuttle/escape)
"zE" = (
/turf/closed/wall/mineral/titanium/nodiagonal,
/area/shuttle/escape)
"zG" = (
/obj/machinery/light{
	dir = 8
	},
/turf/open/floor/plasteel,
/area/shuttle/escape)
"AP" = (
/obj/structure/chair/comfy/shuttle{
	dir = 1
	},
/turf/open/floor/plasteel/dark,
/area/shuttle/escape)
"BC" = (
/obj/structure/window/reinforced,
/obj/structure/shuttle/engine/heater{
	dir = 1
	},
/obj/effect/turf_decal/stripes/line{
	dir = 1
	},
/obj/machinery/door/firedoor/border_only,
/turf/open/floor/plating/airless,
/area/shuttle/escape)
"Cg" = (
/obj/machinery/computer/communications/unlocked{
	dir = 1
	},
/turf/open/floor/plasteel/dark,
/area/shuttle/escape)
"De" = (
/obj/machinery/light/small{
	dir = 8
	},
/obj/structure/chair/comfy/shuttle{
	dir = 4
	},
/turf/open/floor/mineral/plastitanium/red/brig,
/area/shuttle/escape)
"Dg" = (
/obj/structure/chair/comfy/shuttle{
	dir = 4
	},
/obj/effect/turf_decal/bot,
/turf/open/floor/plasteel,
/area/shuttle/escape)
"DC" = (
/obj/structure/table/reinforced,
/obj/machinery/button/door{
	id = "emergecy_vanguard_windows";
	name = "Window Covers"
	},
/turf/open/floor/plasteel/dark,
/area/shuttle/escape)
"Ej" = (
/obj/effect/spawner/structure/window/shuttle,
/obj/machinery/door/firedoor/border_only{
	dir = 8
	},
/obj/machinery/door/poddoor/shutters/preopen{
	id = "emergecy_vanguard_windows"
	},
/turf/open/floor/plating,
/area/shuttle/escape)
"Fo" = (
/obj/machinery/light{
	dir = 8;
	light_color = "#e8eaff"
	},
/turf/open/floor/plasteel,
/area/shuttle/escape)
"Gb" = (
/obj/machinery/atmospherics/pipe/manifold/general/visible{
	dir = 8
	},
/turf/open/floor/plasteel/white,
/area/shuttle/escape)
"Gi" = (
/obj/effect/turf_decal/stripes/corner{
	dir = 8
	},
/turf/open/floor/plasteel,
/area/shuttle/escape)
"Gu" = (
/obj/machinery/recharger,
/obj/structure/table/reinforced,
/turf/open/floor/plasteel/dark,
/area/shuttle/escape)
"Hy" = (
/obj/item/reagent_containers/glass/beaker/cryoxadone,
/obj/structure/table/reinforced,
/turf/open/floor/plasteel/white,
/area/shuttle/escape)
"Ii" = (
/obj/machinery/door/firedoor/border_only{
	dir = 8
	},
/obj/machinery/door/firedoor/border_only{
	dir = 4
	},
/turf/open/floor/plasteel,
/area/shuttle/escape)
"IL" = (
/obj/machinery/suit_storage_unit/standard_unit,
/turf/open/floor/plasteel,
/area/shuttle/escape)
"Jb" = (
/obj/structure/table/optable,
/turf/open/floor/plasteel/white,
/area/shuttle/escape)
"Jd" = (
/obj/machinery/vending/wallmed{
	pixel_y = 29
	},
/turf/open/floor/plasteel/dark,
/area/shuttle/escape)
"Je" = (
/turf/closed/wall/mineral/plastitanium/nodiagonal,
/area/shuttle/escape)
"Jh" = (
/obj/effect/turf_decal/stripes/line,
/turf/open/floor/engine/airless,
/area/shuttle/escape)
"JC" = (
/obj/machinery/light{
	dir = 1
	},
/turf/open/floor/engine/airless,
/area/shuttle/escape)
"JH" = (
/obj/machinery/door/airlock/external{
	name = "Cargo Bay"
	},
/obj/machinery/atmospherics/pipe/simple/supply/hidden/layer2{
	dir = 4
	},
/obj/machinery/atmospherics/pipe/simple/scrubbers/hidden/layer4{
	dir = 8
	},
/turf/open/floor/plating,
/area/shuttle/escape)
"JW" = (
/obj/machinery/conveyor_switch/oneway{
	id = "emergency_vanguard_supplypod_loader"
	},
/turf/open/floor/plasteel/dark,
/area/shuttle/escape)
"Kz" = (
/obj/machinery/computer/operating{
	dir = 1
	},
/turf/open/floor/plasteel/white,
/area/shuttle/escape)
"KT" = (
/obj/item/storage/firstaid/regular{
	pixel_x = 2;
	pixel_y = 3
	},
/obj/structure/table/reinforced,
/obj/item/storage/firstaid/regular{
	pixel_x = -3;
	pixel_y = -3
	},
/turf/open/floor/plasteel/white,
/area/shuttle/escape)
"Ls" = (
/obj/machinery/door/airlock/medical/glass{
	name = "Infirmary"
	},
/obj/machinery/door/firedoor/border_only{
	dir = 1
	},
/obj/machinery/door/firedoor/border_only,
/turf/open/floor/plasteel/white,
/area/shuttle/escape)
"My" = (
/obj/machinery/door/airlock/external/glass{
	name = "NVS Vanguard Secure Transport"
	},
/obj/docking_port/mobile/emergency{
	dheight = 0;
	dwidth = 11;
	height = 18;
	name = "Vanguard Transport Emergency Shuttle";
	port_direction = 4;
	preferred_direction = 2;
	width = 30
	},
/obj/machinery/door/firedoor/border_only{
	dir = 4
	},
/obj/machinery/door/firedoor/border_only{
	dir = 8
	},
/turf/open/floor/plating,
/area/shuttle/escape)
"MC" = (
/obj/structure/chair/comfy/shuttle{
	dir = 1
	},
/turf/open/floor/mineral/plastitanium/red/brig,
/area/shuttle/escape)
"Nv" = (
/obj/machinery/atmospherics/components/unary/thermomachine/freezer,
/turf/open/floor/plasteel/white,
/area/shuttle/escape)
"NJ" = (
/obj/machinery/door/airlock/command/glass{
	name = "Cockpit";
	req_access_txt = "19"
	},
/obj/machinery/door/firedoor/border_only{
	dir = 1
	},
/obj/machinery/door/firedoor/border_only,
/turf/open/floor/plasteel/dark,
/area/shuttle/escape)
"NY" = (
/obj/structure/closet/crate/secure/loot,
/obj/effect/turf_decal/bot,
/turf/open/floor/engine/airless,
/area/shuttle/escape)
"OJ" = (
/obj/structure/chair/comfy/shuttle{
	dir = 8
	},
/obj/machinery/light/small{
	dir = 4
	},
/turf/open/floor/mineral/plastitanium/red/brig,
/area/shuttle/escape)
"OP" = (
/obj/machinery/light{
	dir = 8
	},
/turf/open/floor/engine/airless,
/area/shuttle/escape)
"PR" = (
/obj/machinery/computer/pod{
	id = "emergency_vanguard_cargo";
	name = "supply pod launcher controls"
	},
/turf/open/floor/plasteel/dark,
/area/shuttle/escape)
"Qf" = (
/obj/machinery/light{
	dir = 1
	},
/obj/structure/chair/comfy/shuttle,
/obj/effect/turf_decal/bot,
/turf/open/floor/plasteel,
/area/shuttle/escape)
"SF" = (
/obj/structure/table/reinforced,
/turf/open/floor/mineral/plastitanium/red/brig,
/area/shuttle/escape)
"SL" = (
/obj/effect/spawner/structure/window/shuttle,
/obj/machinery/door/firedoor/border_only{
	dir = 1
	},
/obj/machinery/door/firedoor/border_only,
/turf/open/floor/plating,
/area/shuttle/escape)
"SP" = (
/obj/machinery/vending/wallmed{
	pixel_y = 29
	},
/obj/structure/closet/secure_closet{
	name = "special operations officer's locker";
	req_access = list(20)
	},
/obj/item/clothing/suit/det_suit{
	name = "officer's jacket";
	desc = "A jacket typically used by Nanotrasen Special Operations officers."
	},
/obj/item/clothing/head/beret/sec{
	name = "officer's beret";
	desc = "A beret typically used by Nanotrasen Special Operations officers."
	},
/obj/item/clothing/under/rank/centcom_commander,
/obj/item/clothing/shoes/jackboots,
/turf/open/floor/plasteel/dark,
/area/shuttle/escape)
"Tg" = (
/obj/machinery/light{
	dir = 4
	},
/turf/open/floor/plasteel/dark,
/area/shuttle/escape)
"Uf" = (
/obj/machinery/atmospherics/components/unary/tank/air,
/turf/open/floor/plasteel,
/area/shuttle/escape)
"UF" = (
/turf/open/floor/plasteel,
/area/shuttle/escape)
"UW" = (
/obj/machinery/light/small{
	dir = 4
	},
/obj/structure/table/reinforced,
/obj/machinery/recharger,
/turf/open/floor/mineral/plastitanium/red/brig,
/area/shuttle/escape)
"Vt" = (
/obj/structure/chair/comfy/shuttle{
	dir = 4
	},
/turf/open/floor/mineral/plastitanium/red/brig,
/area/shuttle/escape)
"Wx" = (
/obj/machinery/light{
	dir = 8
	},
/turf/open/floor/plasteel/dark,
/area/shuttle/escape)
"WC" = (
/obj/machinery/atmospherics/pipe/simple/general/visible{
	dir = 9
	},
/turf/open/floor/plasteel/white,
/area/shuttle/escape)
"WR" = (
/obj/effect/spawner/structure/window/shuttle,
/obj/machinery/door/firedoor/border_only,
/obj/machinery/door/firedoor/border_only{
	dir = 8
	},
/obj/machinery/door/poddoor/shutters/preopen{
	id = "emergecy_vanguard_windows"
	},
/turf/open/floor/plating,
/area/shuttle/escape)
"Xb" = (
/obj/machinery/computer/communications/unlocked{
	dir = 4
	},
/turf/open/floor/plasteel/dark,
/area/shuttle/escape)
"Xk" = (
/obj/machinery/door/airlock/external{
	name = "Cargo Bay"
	},
/obj/machinery/atmospherics/pipe/simple/supply/hidden/layer2{
	dir = 4
	},
/obj/machinery/atmospherics/pipe/simple/supply/hidden/layer2{
	dir = 8
	},
/obj/machinery/atmospherics/pipe/simple/scrubbers/hidden/layer4{
	dir = 8
	},
/turf/open/floor/plating,
/area/shuttle/escape)
"Xl" = (
/obj/structure/chair/comfy/shuttle{
	dir = 4
	},
/turf/open/floor/engine/airless,
/area/shuttle/escape)
"Yc" = (
/obj/structure/shuttle/engine/propulsion{
	dir = 1
	},
/obj/effect/turf_decal/stripes/line{
	dir = 1
	},
/turf/open/floor/plating/airless,
/area/shuttle/escape)
"Yi" = (
/obj/machinery/vending/medical,
/turf/open/floor/plasteel/white,
/area/shuttle/escape)
"Yj" = (
/obj/machinery/atmospherics/pipe/layer_manifold,
/turf/open/floor/plasteel,
/area/shuttle/escape)
"ZD" = (
/obj/structure/chair/comfy/shuttle{
	dir = 8
	},
/turf/open/floor/engine/airless,
/area/shuttle/escape)
"ZF" = (
/obj/machinery/computer/emergency_shuttle{
	dir = 1
	},
/turf/open/floor/plasteel/dark,
/area/shuttle/escape)

(1,1,1) = {"
tT
cD
Je
Je
zE
zE
zE
zE
zE
uc
zE
My
zE
Ej
Ej
Ej
zE
yF
zE
yF
zE
zE
zE
zE
zE
zE
zE
nV
tT
"}
(2,1,1) = {"
Yc
BC
UF
UF
UF
zG
UF
UF
UF
UF
zG
UF
zG
UF
UF
UF
zG
UF
Fo
UF
SL
Vt
Vt
De
Vt
zE
in
zE
nV
"}
(3,1,1) = {"
Yc
BC
pg
UF
UF
UF
UF
UF
UF
UF
UF
UF
UF
UF
UF
UF
UF
UF
UF
UF
zo
aT
aT
aT
aT
dd
aT
MC
jb
"}
(4,1,1) = {"
Yc
BC
pg
UF
UF
UF
pu
pu
pu
pu
pu
pu
pu
UF
UF
UF
UF
UF
UF
UF
rP
aT
aT
aT
aT
kj
aT
MC
jb
"}
(5,1,1) = {"
Je
Je
Qf
UF
UF
UF
zE
zE
zE
zE
zE
zE
zE
Uf
Yj
er
bZ
pc
IL
IL
SL
SF
UW
rS
SF
zE
OJ
zE
nV
"}
(6,1,1) = {"
Yc
BC
Ii
Ii
Ii
zE
zE
SP
Wx
iB
rD
fD
zE
zE
zE
Xk
zE
zE
zE
zE
zE
zE
zE
zE
zE
zE
zE
nV
tT
"}
(7,1,1) = {"
Yc
BC
pg
UF
yg
zE
PR
AP
iB
iB
tt
zE
nV
Xl
zE
jf
zE
pN
pN
an
qf
tT
tT
tT
tT
tT
tT
tT
tT
"}
(8,1,1) = {"
Je
Je
Qf
UF
dp
zE
JW
iB
iB
DC
vd
mO
vD
mJ
zE
mv
zE
JC
mm
Jh
qf
tT
tT
tT
tT
tT
tT
tT
tT
"}
(9,1,1) = {"
Yc
BC
pg
UF
ju
NJ
iB
iB
rD
Cg
jb
vD
NY
mm
mm
mm
OP
mm
mm
Jh
qf
tT
tT
tT
tT
tT
tT
tT
tT
"}
(10,1,1) = {"
Yc
BC
pg
UF
ju
NJ
iB
iB
rD
ZF
jb
vN
NY
mm
oW
mm
mm
mm
mm
Jh
qf
tT
tT
tT
tT
tT
tT
tT
tT
"}
(11,1,1) = {"
Je
Je
Qf
UF
Gi
zE
ym
iB
iB
DC
vd
WR
tH
mJ
zE
mv
zE
JC
mm
Jh
qf
tT
tT
tT
tT
tT
tT
tT
tT
"}
(12,1,1) = {"
Yc
BC
pg
UF
yg
zE
Gu
iB
iB
iB
Xb
zE
nV
ZD
zE
rb
zE
pN
pN
an
qf
tT
tT
tT
tT
tT
tT
tT
tT
"}
(13,1,1) = {"
Yc
BC
eq
eq
eq
zE
zE
Jd
Tg
iB
rD
aa
zE
zE
zE
JH
zE
zE
zE
zE
zE
zE
zE
zE
zE
zE
zE
nV
tT
"}
(14,1,1) = {"
Je
Je
Qf
UF
UF
UF
zE
zE
zE
zE
zE
zE
zE
Uf
Yj
jn
bZ
vx
IL
IL
SL
kF
Gb
bH
Hy
iG
Yi
zE
nV
"}
(15,1,1) = {"
Yc
BC
pg
UF
UF
UF
Dg
Dg
Dg
Dg
Dg
Dg
Dg
UF
UF
UF
UF
UF
UF
UF
SL
Nv
WC
hK
hK
hK
hK
Jb
jb
"}
(16,1,1) = {"
Yc
BC
pg
UF
UF
UF
UF
UF
UF
UF
UF
UF
UF
UF
UF
UF
UF
UF
UF
UF
Ls
hK
hK
fc
hK
hK
hK
Kz
jb
"}
(17,1,1) = {"
Yc
BC
UF
UF
UF
dn
UF
UF
UF
UF
dn
UF
vU
UF
UF
UF
dn
UF
vU
UF
Ls
hK
hK
KT
pY
wO
fV
zE
nV
"}
(18,1,1) = {"
tT
cD
Je
Je
zE
zE
zE
zE
zE
yF
zE
yF
zE
gp
gp
gp
zE
yF
zE
yF
zE
zE
zE
zE
zE
zE
zE
nV
tT
"}
